XXXXXXXXXXXXXXXXXXXXXXXXXXXXXXXXXXXXXXXXXXXXXXXXXXXXXXXXXXXXXXXX
X                                                              X
X                                                              X
X                                                              X
X                                                              X
X                                                              X
X                                                              X
X                                                              X
X                               X                              X
X                               X                              X
X                               X                              X
X                               X                              X
X                               X                              X
X                           XXXXXXXXX                          X
X                           XXXXXXXXX                          X
X                      XXXXXXXXXXXXXXXXXXX                     X
X                           XXXXXXXXX                          X
X                           XXXXXXXXX                          X
X                               X                              X
X                               X                              X
X                               X                              X
X                               X                              X
X                               X                              X
X                                                              X
X                                                              X
X                                                              X
X                                                              X
X                                                              X
X                                                              X
X                                                              X
X                                                              X
XXXXXXXXXXXXXXXXXXXXXXXXXXXXXXXXXXXXXXXXXXXXXXXXXXXXXXXXXXXXXXXX
